11111111111111111111111
10000P000000000000000E1
10000CCCCCCCC0000000001
1000CCCCCCCC00000000001
1000CCCCC00000000000001
1000CCCCCCCCCCCCCCC0001
10000000000000000000001
10000000000000000000001
10000000000000000000001
11111111111111111111111
